1111111111111
1P010C00000C1
1000011111001
100011E0C0001
1111111111111