111111111111111
1X0100000000001
100001111000001
100011100000001
10P001111000X01
100001111000001
100100000000001
1001X000E000001
100100000000101
111111111111111
