111111111111111111111111111111111111111111111111111111111111111111111111111
1X01000C00000011X01000C00000011X01000C00000011X01000C00000011X01000C0000001
1X01000C00000011X01000C00000011X01000C00000011X01000C00000011X01000C0000001
1X01000C00000011X01000C00000011X01000C00000011X01000C00000011X01000C0000001
1X01000C00000011X01000C00000011X01000C00000011X01000C00000011X01000C0000001
1X01000C00000011X01000C00000011X01000C00000011X01000C00000011X01000C0000001
1X01000C00000011X01000C00000011X01000C00000011X01000C00P00011X01000C0000001
1X01000C00000011X01000C00000011X01000C00000011X01000C00000011X01000C0000001
1X01000C00000011X01000C00000011X01000C00000011X01000C00E00011X01000C0000001
111111111111111111111111111111111111111111111111111111111111111111111111111
