1111111111111111
1X0C00011110C001
1001X000000C00111
10010E0000001001
1111111111111111